[
  {
    "name": "Movement",
    "grid": [
      "#S###",
      "#..##",
      "##..#",
      "#.#.#",
      "#...#",
      "#..##",
      "##..#",
      "#...#",
      "###X#"
    ],
    "par": 11
  },
  {
    "name": "Barrel",
    "grid": [
      "#S###",
      "#...#",
      "##..#",
      "#...#",
      "#...#",
      "#...#",
      "#..##",
      "##..#",
      "###X#"
    ],
    "par": 9
  },
  {
    "name": "Button",
    "grid": [
      "#S###",
      "#..##",
      "##..#",
      "#.#.#",
      "#...#",
      "#.BO#",
      "#...#",
      "##.G#",
      "###X#"
    ],
    "par": 12
  },
  {
    "name": "Valve",
    "grid": [
      "#S###",
      "#...#",
      "##B.#",
      "#.V##",
      "#.###",
      "#...#",
      "#..##",
      "##..#",
      "###X#"
    ],
    "par": 12
  },
  {
    "name": "Conveyor",
    "grid": [
      "#S###",
      "#>.##",
      "##..#",
      "#.#.#",
      "#...#",
      "#..##",
      "##..#",
      "#...#",
      "###X#"
    ],
    "par": 10
  },
  {
    "name": "Combo",
    "grid": [
      "#S####",
      "#..#.#",
      "#..#.#",
      "##..##",
      "#....#",
      "#..#.#",
      "#...O#",
      "##..G#",
      "#....#",
      "####X#"
    ],
    "par": 14
  }
]